1111111111111111111111111111111111
1E000000K000000C00000C000000000001
1010010100100000101001000K00010101
1010010010101010001001000000010101
1P0000000C00C000000000000K000000C1
1111111111111111111111111111111111