1111111111111111111111
1E00000000000000000001
10100001C0100000000001
10C0010C00000000000001
10000000P00C0000000001
1000000000010000000001
100000100C000C01000001
1111111111111111111111